M11MMMMMMMMMMMMMMMMMMMMMMMMMMMMMMMMMMMMMMMMMMMMMMMMM11MMMMMM
M                        MMMMMMMMM                        MM
M                        MMMMMMMMM                        MM
M                        MMMMMMMMM                        MM
M                        MMMMMMMMM                        MM
M                        MMMMMMMMM                        MM
M                        MMMMMMMMM                        MM
M         ?MMMM?         MMMMMMMMM         MMMMMMMMMMMMMMMMM
M        ZMMMMMMZ        MMMMMMMMM         MMMMMMMMMMMMMMMMM
M        MMMMMMM         MMMMMMMMM         MMMMMMMMMMMMMMMMM
M        ZMMMMM                            MMMMMMMMMMMMMMMMM
M                        MMMMMMMMM         MMMMMMMMMMMMMMMMM
M                        MMMMMMMMM         ?MMMMMMMMMMMMMMMM
M                        MMMMMMMMM                        MM
M                        MMMMMMMMM                        MM
M                        MMMMMMMMM                        MM
M                        MMMMMMMMM                        MM
M                        MMMMMMMMM                        MM
M                        MMMMMMMMM                        MM
M                        MMMMMMMMM                        MM
M                        MMMMMMMMM                        MM
M                        MMMMMMMMM                        MM
M                        MMMMMMMMM                        MM
M                        MMMMMMMMM                        MM
M                        MMMMMMMMM                        MM
M                        MMMMMMMMM                        MM
M                        MMMMMMMMM                        MM
M                        MMMMMMMMM                        MM
M                        MMMMMMMMM                        MM
M                        MMMMMMMMM                        MM
M                        MMMMMMMMM                        MM
M                        MMMMMMMMM                        MM
M                        MMMMMMMMM                        MM
M                        MMMMMMMMM                        MM
M                        MMMMMMMMM                        MM
M                        MMMMMMMMM                        MM
M                        MMMMMMMMM                        MM
M                        MMMMMMMMM                        MM
M     MMMMMMMMMMMMM      MMMMMMMMM                        MM
MMMMMMMMMMMMMMMMMMMMMMMMMMMMMMMMMMMMMMMMMMMMMMMMMMMMMMMMMMMM